################################
#************######************#
#*####*#####*######*#####*####*#
#*####*#####*######*#####*####*#
#******************************#
#*####*##*############*##*####*#
#*####*##****######****##*####*#
#******#####*######*#####******#
#*####*#####        #####*####*#
#***********        ***********#
#*####*#####        #####*####*#
#******#####*######*#####******#
#*####*##****######****##*####*#
#*####*##*############*##*####*#
#******************************#
#*####*#####*######*#####*####*#
#************######************#
################################