############################################################
#***************************####***************************#
#*#########*###############*####*###############*#########*#
#*#########*###############*####*###############*#########*#
#**********************************************************#
#*#########*#####*########################*#####*#########*#
#*#########*#####***********####***********#####*#########*#
#***********###############*####*###############***********#
###########*###############*####*###############*###########
###########*#####**************************#####*###########
###########*#####*########        ########*#####*###########
#*****************########        ########*****************#
#*#########*#####*########        ########*#####*#########*#
#*****#####**************************************#####*****#
#####*#####*#####*########################*#####*#####*#####
#***********#####***********####***********#####***********#
#*#########################*####*#########################*#
#*#########################*####*#########################*#
#**********************************************************#
############################################################