################################
#            ######            #
# #### ##### ###### ##### #### #
#                              #
# #### ## ############ ## #### #
# #### ##    ######    ## #### #
#      ##### ###### #####      #
# #### #####        ##### #### #
#                              #
# #### #####        ##### #### #
#      ##### ###### #####      #
# #### ##    ######    ## #### #
# #### ## ############ ## #### #
#                              #
# #### ##### ###### ##### #### #
#            ######            #
################################