############################################################
#                           ####                           #
# ######### ############### #### ############### ######### #
# ######### ############### #### ############### ######### #
#                                                          #
# ######### ##### ######################## ##### ######### #
# ######### #####           ####           ##### ######### #
#           ############### #### ###############           #
########### ############### #### ############### ###########
########### #####                          ##### ###########
########### ##### ########        ######## ##### ###########
#                 ########        ########                 #
# ######### ##### ########        ######## ##### ######### #
#     #####                                      #####     #
##### ##### ##### ######################## ##### ##### #####
#           #####           ####           #####           #
# ######################### #### ######################### #
# ######################### #### ######################### #
#                                                          #
############################################################